1111111111111111111111111111111111111111111111111111111111111111
1..............................11..............................1
1..............................11..............................1
1..............................11..............................1
1..............................11..............................1
1.....11.......................11..............................1
1....1221......................11..............................1
1....1..1......................11..............................1
1..............................11..............................1
1..............................11..............................1
1..............................11..............................1
1..........P...................11..............................1
1..............................11..............................1
1..............................11..............................1
1..............................11..............................1
1..............................11..............................1
1..............................11..............................1
1..............................11..............................1
1..............................11..............................1
1..............................11..............................1
1..............................11..............................1
1..............................11.............1..1.............1
1..............................11............112211............1
111111111111111..11111111111111111111111111111111111111111111111
111111111111111..11111111111111111111111111111111111111111111111
1..............................11..............................1
1..............................11..............................1
1..............................11..............................1
1..............................11......E.......................1
1..............................11..............................1
1..............................11..............................1
1..............................11..............................1
1..............................11..............................1
1..............................11..............................1
1..............................11..............................1
1...............E..............11..............................1
1..............................11..............................1
1..............................11..............................1
1..............................11..............................1
1..............................11..............................1
1..............................11..............................1
1..............................11..............................1
1..............................11..............................1
1..............................11..............................1
1..............................11..............................1
1..............................11..............................1
1..............................11..............................1
111111111111111..1111111111111111..............................1
111111111111111..1111111111111111..............................1
1..............................................................1
1..............................................................1
1..............................................................1
1..............................................................1
1..............................................................1
1..............................................................1
1..............................................................1
1..............................................................1
1..............................................................1
1..............................................................1
1..............................................................1
1..............................................................1
1..............................................................1
1..............................................................1
1..............................................................1
1..............................................................1
1..............................................................1
1..............................................................1
1..............................................................1
1..............................................................1
1..............................................................1
1..............................................................1
1111111111111111111111111111111111111111111111111111111111111111